Start: (0, 0)
End: (1, 0)
Maze:
01001000010000111110
01010000101000101010
01100000111100101010
01010000100101000001
01001000100101000001